################
#XX LLG@GCVV   #
# # L G  L     #
# #   O O    # #
# # L        # #
# #      V   #X#
# #  G       # #
# #  G   V   # #
# #          # #
# #          # #
# #       ######
# #      #S  # #
# #      #   # #
# ############D#
#        #   DD#
################
